##########
#S...#...#
#.##.#.#.#
#.#..#.#.#
#.#.##.#.#
#.#....#E#
##########