#######
#S....#
#.###.#
#.#E#.#
#.###.#
#.....#
#######