#####################################
#S...................................#
#.#################################.#
#.#.......#...........#...........#.#
#.#.#####.#.#########.#.#########.#.#
#.#.#...#.#.#.......#.#.#.......#.#.#
#.#.#.#.#.#.#.#####.#.#.#.#####.#.#.#
#.#.#.#.#.#.#.#...#.#.#.#.#...#.#.#.#
#.#.#.#.#.#.#.#.#.#.#.#.#.#.#.#.#.#.#
#.#.#.#.#.#.#.#.#.#.#.#.#.#.#.#.#.#.#
#.#.#.#.#.#.#.#.#.#.#.#.#.#.#.#.#.#.#
#...#.#.#.#.#.#.#.#.#.#.#.#.#.#.#...#
#####.#.#.#.#.#.#.#.#.#.#.#.#.#.#####
#.....#.#.#.#.#.#.#.#.#.#.#.#.#.....#
#.#####.#.#.#.#.#.#.#.#.#.#.#.#####.#
#.......#...#...#...#...#...#.......#
#################################E###